XXXXXXX2222XXXXXXX
X              H0X
X                X
X                X
X                X
X                X
X    XX  T2H1    X
X     X XX       X
X    SXX         X
X     XT2X H2    X
X   T0XX  T1     X
X                X
X                X
X     B2         X
X                X
X  H1          H0X
X                X
XXXXXXX1111XXXXXXX

